12 12
............
...G...XXX..
........XXT.
.........X..
............
..XXXXXXXX..
..K.........
............
..X.........
..XX...S....
..XXX.......
............