12 12
............
...G...XXX..
........XX..
.........X..
............
..XXXXXXXX..
............
............
..X.........
..XX...S....
..XXX.......
............